####################
#..................#
#..................#
#..............@...#
#..............#...#
#..........#...#...#
#..........#.......#
#..........#.......#
#..........#####...#
#..................#
#..O...............#
####################
